18 21

0 0 0 0 0 0 0 0 0 0 0 0 0 0 0 0 0 0 0 0 0 
0 0 0 0 0 0 0 0 0 0 0 0 0 0 0 0 0 0 0 0 0 
0 0 0 0 0 6 6 6 6 6 6 6 6 6 0 0 0 0 0 0 0 
0 0 0 0 0 6 6 4 6 6 6 4 6 6 0 0 0 0 0 0 0 
0 0 0 0 0 6 6 4 4 4 4 4 6 6 0 0 0 0 0 0 0 
0 0 0 0 0 6 0 0 4 4 4 0 0 6 0 0 0 0 0 0 0 
0 0 6 6 6 6 0 0 0 0 0 0 0 6 6 6 6 6 6 0 0 
0 0 6 6 6 6 0 0 0 0 0 0 0 6 6 6 6 6 6 0 0 
0 0 6 6 6 6 0 0 0 0 0 0 0 6 6 6 6 6 6 0 0 
0 0 6 5 0 0 0 0 0 0 0 0 0 0 0 0 0 0 6 0 0 
0 0 6 0 0 0 6 0 0 0 0 0 6 0 0 0 0 0 6 0 0 
0 0 6 0 0 0 6 0 0 0 0 0 6 0 0 0 0 0 6 0 0 
0 0 6 0 0 0 0 0 0 0 0 0 0 0 0 0 0 0 6 0 0 
0 0 6 6 6 6 6 6 6 6 6 6 6 6 6 6 6 6 6 0 0 
0 0 6 6 6 6 6 6 6 6 6 6 6 6 6 6 6 6 6 0 0 
0 0 6 6 6 6 6 6 6 6 6 6 6 6 6 6 6 6 6 0 0 
0 0 0 0 0 0 0 0 0 0 0 0 0 0 0 0 0 0 0 0 0 
0 0 0 0 0 0 0 0 0 0 0 0 0 0 0 0 0 0 0 0 0 

  0   0   0   0   0   0   0   0   0   0   0   0   0   0   0   0   0   0   0   0   0 
  0   0   0   0   0   0   0   0   0   0   0   0   0   0   0   0   0   0   0   0   0 
  0   0   0   0   0   6   6   6   6   6   6   6   6   6   0   0   0   0   0   0   0 
  0   0   0   0   0   6   9  12   9   9   9  12   9   6   0   0   0   0   0   0   0 
  0   0   0   0   0   6   9  12   0   1   2  12   9   6   0   0   0   0   0   0   0 
  0   0   0   0   0   9   0   0   0   1   2   0   0   8   0   0   0   0   0   0   0 
  0   0   6   6   6   6   0   0   0   0   0   0   0   6   6   6   6   6   6   0   0 
  0   0   6   9   9   9   0   0   0   0   0   0   0   8   7   7   9   9   6   0   0 
  0   0   6   9   2   9   0   0   0   0   0   0   0   8   2   7   2   7   6   0   0 
  0   0   6   1   0   0   0   0   0   0   0   0   0   0   0   0   0   0   6   0   0 
  0   0   6   0   0   0   5   0   0   0   0   0   5   0   0   0   0   0   6   0   0 
  0   0   6   0   0   0   5   0   0   0   0   0   5   0   0   0   0   0   6   0   0 
  0   0   6   0   0   0   0   0   0   0   0   0   0   0   0   0   0   0   6   0   0 
  0   0   6   6   6   6   6   6   6   6   6   6   6   6   6   6   6   6   6   0   0 
  0   0   7   7   7   7   7   7   7   7   8   7   7   7   7   7   7   7   7   0   0 
  0   0   7   7   7   7   7   7   7   7   8   7   7   7   7   7   7   7   7   0   0 
  0   0   0   0   0   0   0   0   0   0   0   0   0   0   0   0   0   0   0   0   0 
  0   0   0   0   0   0   0   0   0   0   0   0   0   0   0   0   0   0   0   0   0 

  0   0   0   0   0   0   0   0   0   0   0   0   0   0   0   0   0   0   0   0   0 
  0   0   0   0   0   0   0   0   0   0   0   0   0   0   0   0   0   0   0   0   0 
  0   0   0   0   0   6   6   6   5   6   6   6   5   6   0   0   0   0   0   0   0 
  0   0   0   0   0   6   6   6   6   6   6   6   6   6   0   0   0   0   0   0   0 
  0   0   0   0   0   5   6   7  13  13  13   7   6   5   0   0   0   0   0   0   0 
  0   0   0   0   0   6   0   0  14  14  14   0   0   6   0   0   0   0   0   0   0 
  0   0   6   6   5   6   0   0   0   0   0   0   0   6   6   6   6   6   6   0   0 
  0   0   6   6   6   6   0   0   0   0   0   0   0   5   5   5   5   5   6   0   0 
  0   0   6   6   5   6   0   0   0   0   0   0   0   6   5   5   5   5   6   0   0 
  0   0   6   0   0   0   0   0   0   0   0   0   0   0   0   0   0   0   6   0   0 
  0   0   6   0   0   0   6   0   0   0   0   0   6   0   0   0   0   0   6   0   0 
  0   0   6   0   0   0   7   0   0   0   0   0   7   0   0   0   0   0   6   0   0 
  0   0   6   0   0   0   0   0   0   0   0   0   0   0   0   0   0   0   6   0   0 
  0   0   6   5   6   6   6   5   6   5   6   6   5   5   6   6   6   6   6   0   0 
  0   0   5   5   5   6   5   5   5   5   5   5   5   5   5   5   5   5   5   0   0 
  0   0   5   5   5   5   5   5   5   5   6   5   5   5   5   6   5   5   5   0   0 
  0   0   0   0   0   0   0   0   0   0   0   0   0   0   0   0   0   0   0   0   0 
  0   0   0   0   0   0   0   0   0   0   0   0   0   0   0   0   0   0   0   0   0 
