18 21

2 2 2 2 2 2 2 2 2 2 2 2 2 2 2 2 2 2 2 2 2 
2 2 2 2 2 2 2 2 2 2 2 2 2 2 2 2 2 2 2 2 2 
2 2 2 2 2 0 0 0 0 0 0 0 0 0 2 2 2 2 2 2 2 
2 2 2 2 2 0 0 6 0 0 0 6 0 0 2 2 2 2 2 2 2 
2 2 2 2 2 0 0 6 6 6 6 6 0 0 2 2 2 2 2 2 2 
2 2 2 2 2 0 2 2 2 2 2 2 2 0 2 2 2 2 2 2 2 
2 2 0 0 0 0 2 2 2 2 2 2 2 0 0 0 0 0 0 2 2 
2 2 0 0 0 0 2 2 2 2 2 2 2 0 0 0 0 0 0 2 2 
2 2 0 0 6 0 2 2 2 2 2 2 2 0 6 0 6 0 0 2 2 
2 2 0 2 2 2 2 2 2 2 2 2 2 2 2 2 2 2 0 2 2 
2 2 0 2 2 2 2 2 2 2 2 2 2 2 2 2 2 2 0 2 2 
2 2 0 2 2 2 2 2 2 2 2 2 2 2 2 2 2 2 0 2 2 
2 2 0 2 2 2 2 2 2 2 2 2 2 2 2 2 2 2 0 2 2 
2 2 0 0 0 0 0 0 0 0 0 0 0 0 0 0 0 0 0 2 2 
2 2 0 0 0 0 0 0 0 0 0 0 0 0 0 0 0 0 0 2 2 
2 2 0 0 0 0 0 0 0 0 0 0 0 0 0 0 0 0 0 2 2 
2 2 2 2 2 2 2 2 2 2 2 2 2 2 2 2 2 2 2 2 2 
2 2 2 2 2 2 2 2 2 2 2 2 2 2 2 2 2 2 2 2 2 

  0   0   0   0   0   0   0   0   0   0   0   0   0   0   0   0   0   0   0   0   0 
  0   0   0   0   0   0   0   0   0   0   0   0   0   0   0   0   0   0   0   0   0 
  0   0   0   0   0   0   0   0   0   0   0   0   0   0   0   0   0   0   0   0   0 
  0   0   0   0   0   0   0   8   0   0   0   7   0   0   0   0   0   0   0   0   0 
  0   0   0   0   0   0   0   8   9   9   9   9   0   0   0   0   0   0   0   0   0 
  0   0   0   0   0   0   3   3   3   3   3   3   3   0   0   0   0   0   0   0   0 
  0   0   0   0   0   0   3   3   3   3   3   3   3   0   0   0   0   0   0   0   0 
  0   0   0   0   0   0   3   3   3   3   3   3   3   0   0   0   0   0   0   0   0 
  0   0   0   0   9   0   4   4   4   4   4   4   5   0   8   0   9   0   0   0   0 
  0   0   0   0   0   0   0   0   0   0   0   0   0   0   0   0   0   0   0   0   0 
  0   0   0   0   0   0   0   0   0   0   0   0   0   0   0   0   0   0   0   0   0 
  0   0   0   0   0   0   0   0   0   0   0   0   0   0   0   0   0   0   0   0   0 
  0   0   0   0   0   0   0   0   0   0   0   0   0   0   0   0   0   0   0   0   0 
  0   0   0   0   0   0   0   0   0   0   0   0   0   0   0   0   0   0   0   0   0 
  0   0   0   0   0   0   0   0   0   0   0   0   0   0   0   0   0   0   0   0   0 
  0   0   0   0   0   0   0   0   0   0   0   0   0   0   0   0   0   0   0   0   0 
  0   0   0   0   0   0   0   0   0   0   0   0   0   0   0   0   0   0   0   0   0 
  0   0   0   0   0   0   0   0   0   0   0   0   0   0   0   0   0   0   0   0   0 

  0   0   0   0   0   0   0   0   0   0   0   0   0   0   0   0   0   0   0   0   0 
  0   0   0   0   0   0   0   0   0   0   0   0   0   0   0   0   0   0   0   0   0 
  0   0   0   0   0   0   0   0   0   0   0   0   0   0   0   0   0   0   0   0   0 
  0   0   0   0   0   0   0   5   0   0   0   6   0   0   0   0   0   0   0   0   0 
  0   0   0   0   0   0   0   6   6   6   6   6   0   0   0   0   0   0   0   0   0 
  0   0   0   0   0   0   4   4   4   4   4   4   4   0   0   0   0   0   0   0   0 
  0   0   0   0   0   0   4   4   4   4   4   4   4   0   0   0   0   0   0   0   0 
  0   0   0   0   0   0   4   5   4   4   4   4   4   0   0   0   0   0   0   0   0 
  0   0   0   0   6   0   3   3   3   3   3   3   3   0   6   0   6   0   0   0   0 
  0   0   0   6   6   6   6   6   7   6   6   6   6   6   7   6   6   6   0   0   0 
  0   0   0   7   6   6   6   6   6   6   6   6   6   6   6   7   6   6   0   0   0 
  0   0   0   6   6   6   6   6   6   6   6   6   6   6   6   6   6   6   0   0   0 
  0   0   0   6   6   6   6   6   6   6   7   6   6   6   6   6   6   6   0   0   0 
  0   0   0   0   0   0   0   0   0   0   0   0   0   0   0   0   0   0   0   0   0 
  0   0   0   0   0   0   0   0   0   0   0   0   0   0   0   0   0   0   0   0   0 
  0   0   0   0   0   0   0   0   0   0   0   0   0   0   0   0   0   0   0   0   0 
  0   0   0   0   0   0   0   0   0   0   0   0   0   0   0   0   0   0   0   0   0 
  0   0   0   0   0   0   0   0   0   0   0   0   0   0   0   0   0   0   0   0   0 
