22 16

0 0 0 0 0 0 0 0 0 0 0 0 0 0 0 0 
0 0 0 0 0 0 0 0 0 0 0 0 0 0 0 0 
0 0 0 0 0 0 0 0 0 0 0 0 0 0 0 0 
0 0 0 0 0 0 0 0 0 0 0 0 0 0 0 0 
0 0 0 0 0 0 0 0 0 0 0 0 0 0 0 0 
0 0 0 0 0 0 0 0 0 0 0 0 0 0 0 0 
0 0 0 0 0 0 0 0 0 0 0 0 0 0 0 0 
0 0 0 0 0 0 0 0 0 0 0 0 0 0 0 0 
0 0 0 0 0 0 0 0 0 0 0 0 0 0 0 0 
0 0 0 0 0 0 0 0 0 0 0 0 0 0 0 0 
0 0 0 0 0 0 0 0 0 0 0 0 0 0 0 0 
0 0 0 0 0 0 0 0 0 0 0 0 0 0 0 0 
0 0 0 0 0 0 0 0 0 0 0 0 0 0 0 0 
0 0 0 0 0 0 0 0 0 0 0 0 0 0 0 0 
0 0 0 0 0 0 0 0 0 0 0 0 0 0 0 0 
0 0 0 0 0 0 0 0 0 0 0 0 0 0 0 0 
0 0 0 0 0 0 0 0 0 0 0 0 0 0 0 0 
0 0 0 0 0 0 0 0 0 0 0 0 0 0 0 0 
0 0 0 0 0 0 0 0 0 0 0 0 0 0 0 0 
0 0 0 0 0 0 0 0 0 0 0 0 0 0 0 0 
0 0 0 0 0 0 0 0 0 0 0 0 0 0 0 0 
0 0 0 0 0 0 0 0 0 0 0 0 0 0 0 0 

  7   7   7   7   7   7   7   7   7   7   7   7   7   7   7   7 
  7   0   0   0   0   0   0   0   0   0   0   0   0   0   0   7 
  7   0  13  13  13  13  13  13  13  13  13  13  13  13   0   7 
  7   0   0  14  14   0   0  14  14   0  14   0  14  14   0   7 
  7   0  14  14  14  14  14  14  14  14  14  14  14  14   0   7 
  7   0  14  14  14  14  14  14  14  14  14  14  14  14   0   7 
  7   0  14  14  14  14  14  14  14  14  14  14  14  14   0   7 
  7   0  14  14  14  14  14  14  14  14  14  14  14  14   0   7 
  7   0  14  14  14  14  14  14  14  14  14  14  14  14   0   7 
  7   0   0   0   0   0   0   0  14   0   0   0   0   0   0   7 
  7   0  13  13  13  13  13   0  14   0   0  13  13  13   0   7 
  7   0  14  14   0  14  14   0  14   0   0  14  14  14   0   7 
  7   0  14  14  14  14  14  14  14  14   0  14  14  14   0   7 
  7   0  14  14  14  14  14  14  14  14  14  14  14  14   0   7 
  7   0  14  14  14  14  14  14  14  14  14  14  14  14   0   7 
  7   0  14  14  14  14  14  14  14  14  14  14  14  14   0   7 
  7   0  14  14  14  14  14  14  14  14  14  14  14  14   0   7 
  7   0  14  14  14  14  14  14  14  14  14  14  14  14   0   7 
  7   0  14  14  14  14  14  14  14  14  14  14  14  14   0   7 
  7   0   0  14   0   0   0   0   0   0   0   0   0   0   0   7 
  7   7   0  14   0   7   7   7   7   7   7   7   7   7   7   7 
  7   7   7   7   7   7   7   7   7   7   7   7   7   7   7   7 

  7   7   7   7   7   7   7   7   7   7   7   7   7   7   7   7 
  7   0   0   0   0   0   0   0   0   0   0   0   0   0   0   7 
  7   0   2   2   2   2   2   2   2   2   2   2   2   2   0   7 
  7   0   0   2   2   0   0   2   2   0   2   0   2   2   0   7 
  7   0  11  11  11  11  11  11  11  11  11  11  11  11   0   7 
  7   0  11  11  11  11  11  11  11  11  11  11  11  11   0   7 
  7   0  11  11  11  11  11  11  11  11  11  11  11  11   0   7 
  7   0  11  11  11  11  11  11  11  11  11  11  11  11   0   7 
  7   0  11  11  11  11  11  11  11  11  11  11  11  11   0   7 
  7   0   0   0   0   0   0   0  11   0   0   0   0   0   0   7 
  7   0   2   2   2   2   2   0  11   0   0   2   2   2   0   7 
  7   0   2   2   0   2   2   0  11   0   0   2   2   2   0   7 
  7   0  11  11  11  11  11  11  11  11   0  11  11  11   0   7 
  7   0  11  11  11  11  11  11  11  11  11  11  11  11   0   7 
  7   0  11  11  11  11  11  11  11  11  11  11  11  11   0   7 
  7   0  11  11  11  11  11  11  11  11  11  11  11  11   0   7 
  7   0  11  11  11  11  11  11  11  11  11  11  11  11   0   7 
  7   0  11  11  11  11  11  11  11  11  11  11  11  11   0   7 
  7   0  11  11  11  11  11  11  11  11  11  11  11  11   0   7 
  7   0   0  11   0   0   0   0   0   0   0   0   0   0   0   7 
  7   7   0  11   0   7   7   7   7   7   7   7   7   7   7   7 
  7   7   7   7   7   7   7   7   7   7   7   7   7   7   7   7 
