22 16

0 0 0 0 0 0 0 0 0 0 0 0 0 0 0 0 
0 0 0 0 0 0 0 0 0 0 0 0 0 0 0 0 
0 0 0 0 0 0 0 4 4 0 4 0 4 0 0 0 
0 0 4 4 4 0 0 4 4 0 4 0 4 4 0 0 
0 0 4 4 4 0 0 4 4 0 0 0 0 4 0 0 
0 0 0 0 4 0 0 0 0 0 0 0 0 0 0 0 
0 0 4 0 0 0 0 0 0 0 0 0 0 0 0 0 
0 0 4 0 0 0 0 0 0 0 0 0 0 0 0 0 
0 0 4 0 0 0 0 0 0 0 0 0 0 0 0 0 
0 0 0 0 0 0 0 0 0 0 0 0 0 0 0 0 
0 0 0 0 0 0 0 1 0 1 0 0 4 0 0 0 
0 0 4 4 0 0 0 1 0 1 0 4 4 4 0 0 
0 0 4 4 0 0 0 0 0 0 0 4 4 4 0 0 
0 0 0 0 0 0 0 0 0 0 0 0 0 0 0 0 
0 0 0 0 0 0 0 0 0 0 0 0 0 0 0 0 
0 0 0 0 0 0 0 0 0 0 4 0 0 0 0 0 
0 0 0 0 0 0 4 0 0 0 4 0 0 0 0 0 
0 0 0 0 5 0 4 0 0 0 0 4 4 0 0 0 
0 0 0 0 0 0 4 0 0 0 0 0 0 0 0 0 
0 0 1 0 1 0 0 0 0 0 0 0 0 0 0 0 
0 0 0 0 0 0 0 0 0 0 0 0 0 0 0 0 
0 0 0 0 0 0 0 0 0 0 0 0 0 0 0 0 

  0   0   0   0   0   0   0   0   0   0   0   0   0   0   0   0 
  0  14  14  14  14  14  14  14  14  14  14  14  14  14  13   0 
  0  14   0   0   0   0   0   1   2   0   5   0   5   0  13   0 
  0  14   8  11  12  14  14   1   2  14   5  14   5   7  13   0 
  0  14   8  11  12   0   0   1   2   0   0   0   0   7  13   0 
  0  14   0   0   0   0   0   0   0   0   0   0   0   0  13   0 
  0  14  14   0   0   0   0   0   0   0   0   0   0   0  13   0 
  0  14  14   0   0   0   0   0   0   0   0   0   0   0  13   0 
  0  14  14   0   0   0   0   0   0   0   0   0   0   0  13   0 
  0  10  15  15  15  15  15  13   0  14  14  15  15  15   9   0 
  0  14   0   0   0   2   3   5   0   4  13   0  14   0  13   0 
  0  14   9  12  14   2   3   5   0   4  13   5   6   7  13   0 
  0  14   9  12   0   0   0   0   0   0  14   5   6   7  13   0 
  0  14   0   0   0   0   0   0   0   0   0   0   0   0  13   0 
  0  14   0   0   0   0   0   0   0   0   0   0   0   0  13   0 
  0  14   0   0   0  14   0   0   0   0   0  13  14   0  13   0 
  0  14   0   0   0  15   3   0   0   0   0  13  14   0  13   0 
  0  14   0   0   9  15   3   0   0   0   0   0   0   0  13   0 
  0  14   0   0   0  15   3   0   0   0   0   0   0   0  13   0 
  0  14   5   0   4  10  13  13  13  13  13  13  13  13  13   0 
  0   0  14   0  13   0   0   0   0   0   0   0   0   0   0   0 
  0   0   0   0   0   0   0   0   0   0   0   0   0   0   0   0 

  0   0   0   0   0   0   0   0   0   0   0   0   0   0   0   0 
  0   1   7   7   7   7   7   7   7   7   7   7   7   7   1   0 
  0   6   0   0   0   0   0  10  10   0   6   0   6   0   7   0 
  0   6   0   0   4   2   2  11  11   2   7   2   7  10   7   0 
  0   6   1   1   5   0   0  12  12   0   0   0   0  11   7   0 
  0   6   0   0   9   0   0   0   0   0   0   0   0   0   7   0 
  0   6   2   0   0   0   0   0   0   0   0   0   0   0   7   0 
  0   6   3   0   0   0   0   0   0   0   0   0   0   0   7   0 
  0   6   4   0   0   0   0   0   0   0   0   0   0   0   7   0 
  0   9   8   8   8   8   8   4   0   3  10   8   8   8   8   0 
  0   6   0   0   0  17  17   8   0   8   3   0  12   0   7   0 
  0   6   0   0   2  18  18   9   0   9   8   0   0   0   7   0 
  0   6   1   1   0   0   0   0   0   0   8   1   1   1   7   0 
  0   6   0   0   0   0   0   0   0   0   0   0   0   0   7   0 
  0   6   0   0   0   0   0   0   0   0   0   0   0   0   7   0 
  0   6   0   0   0   4   0   0   0   0   9  12  12   0   7   0 
  0   6   0   0   0  11  13   0   0   0   9  13  13   0   7   0 
  0   6   0   0   9  11  14   0   0   0   0   9   9   0   7   0 
  0   6   0   0   0  11  15   0   0   0   0   0   0   0   7   0 
  0   0   6   0   6   8   6   6   6   6   6   6   6   6   0   0 
  0   0   6   0   7   0   0   0   0   0   0   0   0   0   0   0 
  0   0   0   0   0   0   0   0   0   0   0   0   0   0   0   0 
