13 16

0 0 0 0 0 0 0 0 0 0 0 0 0 0 0 0 
0 0 0 0 0 0 0 0 0 0 0 0 0 0 0 0 
0 0 0 0 0 0 0 0 0 0 0 0 0 0 0 0 
0 0 0 0 0 0 0 0 0 0 0 4 6 0 0 0 
0 0 4 0 0 0 0 0 0 4 4 4 6 0 0 0 
0 0 6 6 6 6 6 0 0 0 0 0 0 0 0 0 
0 0 6 6 6 6 6 0 0 0 0 0 0 0 0 0 
0 0 0 0 0 0 0 0 0 0 0 0 0 0 0 0 
0 0 0 0 0 0 0 0 0 0 0 0 0 0 0 0 
0 0 0 0 0 0 0 0 0 0 0 0 0 0 0 0 
0 0 0 0 0 0 0 0 0 0 0 1 0 1 0 0 
0 0 0 0 0 0 0 0 0 0 0 0 0 0 0 0 
0 0 0 0 0 0 0 0 0 0 0 0 0 0 0 0 

  7   7   7   7   7   7   7   7   7   7   7   7   7   7   7   7 
  7  14  14  14  14  14  14  14  14  14  14  14  14  14  13   7 
  7  14  13  13  13  13  13  13  13  13  13  13  13  13  13   7 
  7  14   0  14  14  14  14  14  14  14  14   9   6  14  13   7 
  7  14  15   0   0   0   0   0   0   8  10   9   6   0  13   7 
  7  14  10  10  10   9  10   0   0   0   0   0   0   0  13   7 
  7  14  10  10  10   9  10   0   0   0   0   0   0   0  13   7 
  7  14   0   0   0   0   0   0   0   0   0   0   0   0  13   7 
  7  14   0   0   0   0   0   0   0   0   0   0   0   0  13   7 
  7  14   0   0   0   0   0   0   0   0   0   0   0   0  13   7 
  7  14  13  13  13  13  13  13  13  13  13   5   0   4  13   7 
  7   7   7   7   7   7   7   7   7   7   7  14   0  13   7   7 
  7   7   7   7   7   7   7   7   7   7   7   7   7   7   7   7 

  7   7   7   7   7   7   7   7   7   7   7   7   7   7   7   7 
  7   1   7   7   7   7   7   7   7   7   7   7   7   7   1   7 
  7   6   2   2   2   2   2   2   2   2   2   2   2   2   7   7 
  7   6   0   2   2   2   2   2   2   2   2  10   8   2   7   7 
  7   6   4   0   0   0   0   0   0  10  11  11   9   0   7   7 
  7   6   5   5   5   7   7   0   0   0   0   0   0   0   7   7 
  7   6   6   6   6   8   8   0   0   0   0   0   0   0   7   7 
  7   6   0   0   0   0   0   0   0   0   0   0   0   0   7   7 
  7   6   0   0   0   0   0   0   0   0   0   0   0   0   7   7 
  7   6   0   0   0   0   0   0   0   0   0   0   0   0   7   7 
  7   0   6   6   6   6   6   6   6   6   6   6   0   6   0   7 
  7   7   7   7   7   7   7   7   7   7   7   6   0   7   7   7 
  7   7   7   7   7   7   7   7   7   7   7   7   7   7   7   7 
