21 35

0 0 0 0 0 0 0 0 0 0 0 0 0 0 0 0 0 0 0 0 0 0 0 0 0 0 0 0 0 0 0 0 0 0 0 
0 0 0 0 0 0 0 0 0 0 0 0 0 0 0 0 0 0 0 0 0 0 0 0 0 0 0 6 6 0 0 0 0 0 0 
0 0 0 0 0 0 0 0 0 0 0 0 0 0 0 0 0 0 0 0 0 0 0 0 0 0 0 6 6 6 0 0 0 0 0 
0 0 0 0 0 0 0 0 0 0 0 0 0 0 0 0 0 0 0 0 0 0 0 0 0 0 0 6 6 6 0 0 0 0 0 
0 0 0 0 0 0 0 0 0 0 0 0 0 0 3 3 0 0 0 0 0 0 0 0 0 0 0 0 0 0 0 0 0 0 0 
0 0 0 0 0 0 0 0 0 0 0 0 0 0 3 3 0 0 0 0 0 0 0 0 0 0 0 0 0 0 0 0 0 0 0 
0 0 0 0 0 0 0 0 2 0 0 0 0 0 0 0 0 0 0 0 0 0 0 0 0 0 0 0 0 0 0 0 0 0 0 
0 0 0 0 0 0 0 0 0 0 0 0 0 0 0 0 0 2 2 2 0 0 0 0 0 0 0 0 0 0 0 0 0 0 0 
0 0 0 0 0 6 6 0 0 0 0 0 0 0 2 2 2 2 2 2 0 0 0 0 0 0 0 0 0 0 0 0 0 0 0 
0 0 0 0 0 6 6 6 0 0 0 0 0 0 2 2 2 2 2 2 0 0 0 0 0 0 0 0 0 0 0 0 0 0 0 
0 0 0 0 0 0 6 6 0 0 0 0 0 0 2 2 2 0 0 0 0 0 0 0 0 0 0 0 0 0 0 0 0 0 0 
0 0 0 0 0 0 0 0 0 0 0 0 0 0 0 0 0 0 0 0 0 0 0 0 0 0 0 0 0 0 0 0 0 0 0 
0 0 0 0 0 0 0 0 0 0 0 0 0 0 0 0 0 0 0 0 0 0 0 0 0 0 0 0 0 0 0 0 0 0 0 
0 0 0 0 0 0 0 0 0 0 0 0 0 0 0 0 0 0 0 0 0 0 0 0 0 0 0 0 0 0 0 0 0 0 0 
0 0 0 0 0 0 0 0 0 0 0 0 0 0 0 0 0 0 0 0 0 0 0 0 0 0 0 0 0 0 0 0 0 0 0 
0 0 0 0 0 0 0 0 0 6 6 6 0 0 0 0 0 0 0 0 0 0 0 0 0 0 0 0 0 0 0 0 0 0 0 
0 6 6 0 0 0 0 0 0 6 6 6 0 0 0 0 0 0 0 0 0 0 0 0 0 0 0 0 0 0 0 0 0 0 0 
0 6 6 6 0 0 0 0 0 0 0 0 0 0 0 0 0 0 0 0 0 0 0 0 0 0 0 0 0 0 0 0 0 0 0 
6 6 6 6 0 0 0 0 0 0 0 0 0 0 0 0 0 0 0 0 0 0 0 0 0 0 0 0 0 0 0 0 0 0 0 
6 6 6 0 0 0 0 0 0 0 0 0 0 0 0 0 0 0 0 0 0 0 0 0 0 0 0 0 0 0 0 0 0 0 0 
6 6 6 0 0 0 0 0 0 0 0 0 0 0 0 0 0 0 0 0 0 0 0 0 0 0 0 0 0 0 0 0 0 0 0 

  7   7   7   7   7   7   7   7   7   7   7   7   7   7   7   7   7   7   7   7   7   7   7   0   3   5   0   7   7   7   7   7   0   7   7 
  7   7   7   7   7  12   7   7   7   7   7   7   7   7   7   7   7   7   7  11   7   7   7   0   3   5   0   6   8   7   7  12   0   7   7 
  7   7   7  12   7   8   0   0   0   0   0   0   0   0   0   0   0   0   0   6   7  11  12   0   3   5   0   6   7   8   7   0   0   7   7 
  7   7   7   8   0   0   0   0   0   0   0   0   0   0   0   0   0   0   0   0   0   6   8   3   3   5   0   6   7   8   7   0   0   7   7 
  7   7   7   8   0   0   7   7   0   0   0   0   0   0   7   7   0   7   7   0   0   0   0   3   3   5   0   7   7   7   7   0   7   7   7 
  0   0   0   0   7   7   7   7   0   0   0   0   0   0   7   7   0   7   7   7   7   0   0   3  11   5   5   0   0   0   0   0   0   0   7 
  0   0   0   0   7   7   7   7   2   7   7   7   7   7   7   7   0   7   7   7   7   7   7   3   4   5   5   0   0   0   0   0   0   0   7 
  4   4   4   4   5   7   7   7   5   5   5   0   5   5   5   5   0   7   7   7   7   7   7   3  11  12   5   0   0   0   0   0   0   0   7 
  4   4   4  11   5   6   8   7   7   9   7   7   7   7   5   6   7   7   7   7   7   7   7   7   3  11   5   0   0   0   0   0   0   0   7 
  7   0   7   3   5   6   7   8   7   9   7   7   7   7   5   6   7   7   7   7   7   7   7   7   7   3   5   0   0   0   0   0   7   0   7 
  7   0   7   3  12   5   6   8   7   9   7   7   7   7   5   6   7   7   7   7   7   7   7   7   7   3   5   0   0   0   0   0   5   0   7 
  7   0   7   7   3  12   5   7   3   5   7   7   7   7   7   7   7   7   7   7   7   3   4   4   4  11   5   7   3   4   8   8  15   0   7 
  7   0   7   7   3  11  12   4  11  12   4   4   4   4   4   5   7   7   7   3   4  11  12   4   4  11  12   8   4   5   7   7   7   0   7 
  7   0   7   7   7   3  11   4   4   4  12   4   4   4   4  12   4   4   4  11   4  12   5   7   7   3   5   7   7   7   7   7   7   0   7 
  7   0   7   7   7   7   3   4   4   4   5   7   7   7   7   3   4   4   4   4   4   5   7   7   7   3   5   7   7   7   7   7   7   0   7 
  7   0   0   0   7   7   7   7   7   6   7   8   7   7   7   7   7   7   7   7   7   7   7   7   3  11   5   7   7   7   7   7   7   0   7 
  7   6   8   0   0   0   0   0   0   6   7   8   7   7   7   7   0   0   0   0   0   0   0   0   3   4   5   0   0   0   0   0   0   0   7 
  7   6   7   8   7   7   7   7   0   0   0   0   0   0   0   0   0   7   7   7   7   7   7   7   3  12   5   7   7   7   7   7   7   7   7 
  6   6   7   8   7   7   7   7   7   7   7   7   7   7   7   7   7   7   7   7   7   7   7   7   3   5   7   7   7   7   7   7   7   7   7 
  6   7   8   7   7   7   7   7   7   7   7   7   7   7   7   7   7   7   7   7   7   7   7   3  11   5   7   7   7   7   7   7   7   7   7 
  6   7   8   7   7   7   7   7   7   7   7   7   7   7   7   7   7   7   7   7   7   7   7   3   4   5   7   7   7   7   7   7   7   7   7 

  4   4   4   4   4   4   4   4   4   4   4   4   4   4   4   4   4   4   4   4   4   4   4   0   7   7   0   4   4   4   4   4   0   4   4 
  4   4   4   4   4   5   5   5   5   5   5   5   5   5   5   5   5   5   5   5   4   4   4   0   7   7   0   0   0   4   4   5   0   4   4 
  4   4   4   5   5   5   0   0   0   0   0   0   0   0   0   0   0   0   0   5   5   5   5   0   7   7   0   1   3   0   4   0   0   4   4 
  4   4   4   4   0   0   0   0   0   0   0   0   0   0   0   0   0   0   0   0   0   5   5   6   7   7   0   2   2   2   4   0   0   4   4 
  5   5   5   5   0   0   4   4   0   0   0   0   0   0   1   1   0   4   4   0   0   0   0   7   7   7   0   5   5   5   5   0   4   4   4 
  0   0   0   0   4   4   4   4   0   0   0   0   0   0   2   2   0   4   4   4   4   0   0   6   6   7   6   0   0   0   0   0   0   0   4 
  0   0   0   0   4   4   4   4  12  17  17  17  17  17  17  17   0   4   4   4   4   4   4   7   7   7   7   0   0   0   0   0   0   0   4 
  6   6   6   6   6   4   4   4  17  17  17   0  17  17  17  17   0  12  12  12   4   4   4   8   7   6   6   0   0   0   0   0   0   0   4 
  8   8   8   7   7   0   0   4   4  16   4   4   4   4  15  15  15  13  13  13   4   4   4   4   8   7   7   0   0   0   0   0   0   0   4 
  4   0   4   7   7   2   3   0   4  16   4   4   4   4  15  15  15  14  14  14   4   4   4   4   4   7   7   0   0   0   0   0  17   0   4 
  4   0   4   8   6   6   2   2   4  16   4   4   4   4  15  15  15   4   4   4   4   4   4   4   4   7   7   0   0   0   0   0  17   0   4 
  4   0   4   4   7   6   6   4   6   7   4   4   4   4   4   4   4   4   4   4   4   6   6   6   6   6   7   4   6   6  16  16  16   0   4 
  4   0   4   4   8   7   6   6   6   6   6   6   6   6   6   6   4   4   4   6   6   6   7   8   8   7   6  16   8   8   4   4   4   0   4 
  4   0   4   4   4   8   7   7   7   7   7   8   8   8   8   6   6   6   6   6   7   7   8   4   4   7   7   4   4   4   4   4   4   0   4 
  4   0   4   4   4   4   8   8   8   8   8   4   4   4   4   8   8   8   8   8   8   8   4   4   4   7   7   4   4   4   4   4   4   0   4 
  4   0   0   0   4   4   4   4   4   0   0   0   4   4   4   4   4   4   4   4   4   4   4   4   6   6   7   4   4   4   4   4   4   0   4 
  4   0   0   0   0   0   0   0   0   2   2   2   4   4   4   4   0   0   0   0   0   0   0   0   7   7   7   0   0   0   0   0   0   0   4 
  4   1   3   0   4   4   4   4   0   0   0   0   0   0   0   0   0   4   4   4   4   4   4   4   7   7   8   4   4   4   4   4   4   4   4 
  0   3   1   2   4   4   4   4   4   4   4   4   4   4   4   4   4   4   4   4   4   4   4   4   7   7   4   4   4   4   4   4   4   4   4 
  1   1   1   4   4   4   4   4   4   4   4   4   4   4   4   4   4   4   4   4   4   4   4   6   6   7   4   4   4   4   4   4   4   4   4 
  2   2   2   4   4   4   4   4   4   4   4   4   4   4   4   4   4   4   4   4   4   4   4   7   7   7   4   4   4   4   4   4   4   4   4 
