21 35

0 0 0 0 0 0 0 0 0 0 0 0 0 0 0 0 0 0 0 0 0 0 0 0 0 0 0 0 0 0 0 0 0 0 0 
0 0 0 0 0 0 0 0 0 0 0 0 0 0 0 0 0 0 0 0 0 0 0 0 0 0 0 0 0 0 0 0 0 0 0 
0 0 0 0 0 0 1 1 3 3 3 3 3 3 3 3 3 1 1 0 0 0 0 0 0 0 0 0 0 0 0 0 1 0 0 
0 0 0 0 1 1 1 1 3 3 3 3 3 3 3 3 3 1 1 1 1 0 0 1 0 0 0 0 0 0 0 0 1 0 0 
0 0 0 0 1 1 0 0 3 3 3 3 3 3 3 3 3 0 0 1 1 1 1 1 0 0 0 0 0 0 0 0 0 0 0 
1 1 1 1 0 0 0 0 3 3 3 3 3 3 3 3 3 0 0 0 0 1 1 0 0 0 1 3 3 3 3 3 3 3 0 
1 1 1 1 0 0 5 5 0 3 3 0 3 3 3 3 0 0 0 0 0 0 0 0 0 0 1 3 3 3 3 3 3 3 0 
0 0 0 0 0 0 5 5 3 3 3 0 3 3 3 3 0 0 0 0 0 0 0 0 0 0 0 3 3 3 3 3 3 3 0 
0 0 0 0 0 0 0 0 0 0 0 0 0 0 0 0 0 0 0 0 0 0 0 0 0 0 0 3 3 3 3 3 3 3 0 
0 0 0 0 0 0 0 0 0 0 0 0 5 0 0 0 0 0 0 0 0 0 0 0 0 0 0 2 0 0 0 0 3 0 0 
0 0 0 0 0 0 0 0 0 0 0 0 0 0 0 0 0 0 0 0 0 0 0 0 0 0 0 0 0 0 0 0 3 0 0 
0 0 0 0 0 0 0 0 0 0 0 0 0 0 0 0 0 0 0 0 0 0 0 0 0 0 0 0 0 0 0 0 0 0 0 
0 0 0 0 0 0 0 0 0 0 0 0 0 0 0 0 0 0 0 0 0 0 0 0 0 0 0 0 0 0 0 0 0 0 0 
0 0 0 0 0 0 0 0 0 0 0 0 0 0 0 0 0 0 0 0 0 0 0 0 0 0 0 0 0 0 0 6 0 0 0 
0 0 0 0 0 0 0 0 0 0 0 6 0 0 0 0 0 0 0 0 0 0 0 0 0 0 0 0 0 0 6 6 0 0 0 
0 0 0 0 0 0 0 0 0 0 6 6 6 6 0 0 0 0 0 0 0 0 0 0 0 0 0 0 0 0 6 0 0 0 0 
0 0 0 0 0 0 0 0 0 0 6 0 6 6 0 0 0 0 0 0 0 0 0 6 0 0 0 0 0 0 0 0 0 0 0 
0 0 6 0 0 0 0 0 0 0 0 0 0 0 0 0 0 0 0 0 0 0 0 0 0 0 0 0 0 0 0 0 0 0 0 
0 5 0 0 0 0 0 0 0 0 0 0 0 0 0 0 0 0 0 0 0 0 0 0 0 0 0 0 0 0 0 0 0 0 0 
0 6 0 6 0 0 0 0 0 0 0 0 0 0 0 0 0 0 0 0 0 0 0 0 0 0 0 0 0 0 0 0 0 0 0 
0 0 0 0 0 0 0 0 0 0 0 0 0 0 0 0 0 0 0 0 0 0 0 0 0 0 0 0 0 0 0 0 0 0 0 

  0   0   0   0   0   0   0   0   0   0   0   0   0   0   0   0   0   0   0   0   0   0   0   8   0   0   6   0   0   0   0   0   8   0   0 
  0   0   0   0   0   0   0   0   0   0   0   0   0   0   0   0   0   0   0   0   0   0   0   8   0   0   6   0   0   0   0   0   8   0   0 
  0   0   0   0   0   0   0   1   7   7   7   7   7   7   7   7   7   1   1   0   0   0   0   8   0   0   6   0   0   0   0   8   1   0   0 
  0   0   0   0   0   1   0   1   7   7   7   7   7   7   7   7   7   0   1   0   1   0   0   1   0   0   6   0   0   0   0   8   1   0   0 
  0   0   0   0   0   1   0   0   7   7   7   7   7   7   5   6   7   0   0   0   1   0   1   1   0   0   6   0   0   0   0   8   0   0   0 
  0   0   1   1   0   0   0   0   7   7   7   7   7   7   5   6   7   0   0   0   0   0   1   0   0   0   0   7   7   7   7   7   7   7   0 
  0   1   1   1   0   0  10  11   0   7   4   0  14  15  14  15   7   0   0   0   0   0   0   0   0   0   0   7   7   7   7   7   7   7   0 
  0   0   0   0   0   0  10  11  10   7   4   5  14  15  14  15   5   0   0   0   0   0   0   0   0   0   0   7   7   7   7   7   7   7   0 
  0   0   0   0   0   0   0   0   0   0   0   0   0   0   0   0   0   0   0   0   0   0   0   0   0   0   0   7   7   7   7   7   7   7   0 
  1   3   0   0   0   0   0   0   0   0   0   0   8   0   0   0   0   0   0   0   0   0   0   0   0   0   0   2   7   7   7   7   7   7   0 
  0   0   0   0   0   0   0   0   0   0   0   0   0   0   0   0   0   0   0   0   0   0   0   0   0   0   0   5   5   5   5   5   7   5   0 
  0   0   0   0   0   0   0   0   0   0   0   0   0   0   0   0   0   0   0   0   0   0   0   0   0   0   0   0   0   0   0   0   0   0   0 
  0   0   0   0   0   0   0   0   0   0   0   0   0   0   0   0   0   0   0   0   0   0   0   0   0   0   0   0   0   0   0   0   0   0   0 
  0   0   0   0   0   0   0   0   0   0   0   0   0   0   0   0   0   0   0   0   0   0   0   0   0   0   0   0   0   0   0   0   0   0   0 
  0   0   0   0   0   0   0   0   0   0   0   0   0   0   0   0   0   0   0   0   0   0   0   0   0   0   0   0   0   0   0   0   0   0   0 
  0   2   1   3   0   0   0   0   0   0   0   0   0   4   0   0   0   0   0   0   0   0   0   0   0   0   0   0   0   0   0   0   0   0   0 
  0   0   0   2   1   1   1   1   3   0   0   0   0   2   0   0   2   1   1   1   1   1   1   0   0   0   0   2   1   1   1   1   1   3   0 
  0   0   2   0   0   0   0   0   2   1   1   1   1   1   1   1   3   0   0   0   0   0   0   0   0   0   0   0   0   0   0   0   0   0   0 
  0   0   0   0   0   0   0   0   0   0   0   0   0   0   0   0   0   0   0   0   0   0   0   0   0   0   0   0   0   0   0   0   0   0   0 
  0   2   0   6   0   0   0   0   0   0   0   0   0   0   0   0   0   0   0   0   0   0   0   0   0   0   0   0   0   0   0   0   0   0   0 
  0   0   0   0   0   0   0   0   0   0   0   0   0   0   0   0   0   0   0   0   0   0   0   0   0   0   0   0   0   0   0   0   0   0   0 

  0   0   0   0   0   0   0   0   0   0   0   0   0   0   0   0   0   0   0   0   0   0   0   4   0   0   4   0   0   0   0   0   4   0   0 
  0   0   0   0   0   0   0   0   0   0   0   0   0   0   0   0   0   0   0   0   0   0   0   4   0   0   4   0   0   0   0   0   5   0   0 
  0   0   0   0   0   0   3   3   0   0   0   0   0   0   0   0   0   3   3   0   0   0   0   5   0   0   4   0   0   0   0   4   3   0   0 
  0   0   0   0   3   3   3   4   1   1   1   1   1   1   1   1   1   4   3   3   3   0   0   3   0   0   4   0   0   0   0   4   4   0   0 
  0   0   0   0   3   4   0   0   1   1   1   1   1   1   0   0   1   0   0   4   3   3   3   4   0   0   5   0   0   0   0   5   0   0   0 
  3   3   3   3   0   0   0   0   2   2   2   2   2   2   2   2   2   0   0   0   0   4   4   0   0   0   3   0   0   0   0   0   0   0   0 
  3   3   3   4   0   0  12  12   0   4   9   0   2   2   2   2  17   0   0   0   0   0   0   0   0   0   4   1   1   1   1   1   1   1   0 
  0   0   0   0   0   0  13  13  12   5  10  17   3   3   5   5  17   0   0   0   0   0   0   0   0   0   0   1   1   1   1   1   1   1   0 
  0   0   0   0   0   0   0   0   0   0   0   0   0   0   0   0   0   0   0   0   0   0   0   0   0   0   0   2   2   2   2   2   2   2   0 
 15  14   0   0   0   0   0   0   0   0   0   0  14   0   0   0   0   0   0   0   0   0   0   0   0   0   0  12  17  17  17  17   4  17   0 
  0  13   0   0   0   0   0   0   0   0   0   0   0   0   0   0   0   0   0   0   0   0   0   0   0   0   0  17  17  17  17  17   5  17   0 
  0  13   0   0   0   0   0   0   0   0   0   0   0   0   0   0   0   0   0   0   0   0   0   0   0   0   0   0   0   0   0   0   0  13   0 
  0  13   0   0   0   0   0   0   0   0   0   0   0   0   0   0   0   0   0   0   0   0   0   0   0   0   0   0   0   0   0   0   0  13   0 
  0  13   0   0   0   0   0   0   0   0   0   0   0   0   0   0   0   0   0   0   0   0   0   0   0   0   0   0   0   0   0   0   0  13   0 
  0  13   0   0   0   0   0   0   0   0   0   0   0   0   0   0   0   0   0   0   0   0   0   0   0   0   0   0   0   0   0   1   0  13   0 
  0  15  15  14   0   0   0   0   0   0   0   1   0   2   0   0   0   0   0   0   0   0   0   0   0   0   0   0   0   0   1   0   0  13   0 
  0   0   0  15  15  15  15  15  14   0   1   0   1   2   0   0  14  15  15  15  15  15  15   4   0   0   0  15  15  15  15  15  15  15   0 
  0   0   4   0   0   0   0   0  15  15  15  15  15  15  15  15  15   0   0   0   0   0   0   0   0   0   0   0   0   0   0   0   0   0   0 
  0   1   0   0   0   0   0   0   0   0   0   0   0   0   0   0   0   0   0   0   0   0   0   0   0   0   0   0   0   0   0   0   0   0   0 
  0   4   0   7   0   0   0   0   0   0   0   0   0   0   0   0   0   0   0   0   0   0   0   0   0   0   0   0   0   0   0   0   0   0   0 
  0   0   0   0   0   0   0   0   0   0   0   0   0   0   0   0   0   0   0   0   0   0   0   0   0   0   0   0   0   0   0   0   0   0   0 
